WWWCWWWWWWW
W   W   W W
W WWWWW W W
W   SW  W W
WWWW WW W W
WE W    W W
W WW WW W W
W    W    W
WWWPWWWWWWW