WWWF    C
W       W W
W    W W
W      WW W W
WE W    W W
W WW WW W W
W    W    W
WWWPWWWWWWW